11111111111
10E00000001
10000C00001
10000000P01
10C0000C001
100C0000001
11111111111